---------------------------------------------------------------------------------xxx--------xxx-----
-------------------------------------------------------------------------------xxx--x------xx--x----
-------------------------------------------------------------------------------xx----x----xx----x---
------------------------------------------------------------------------------xx------x--xx------x--
----------------------------------------------------------------------------xxx--------xxx--------x-
----------------XXXX-------------------------------------------------------xxXX--------XXX---------x
--------------------------------------------------------------------------xxXXX--------XXX---------X
-------------------------------------------------------------------------xxXXXX--------XXX----------
------------------------------------------------------------------------xxXXXXX--------XXX----------
-----------------------------------------------------------------------xxXXXXXXS-------XXX----------
--------xxx-----------------------------------------------------------xxXXXXXXX--------XXX----------
xxx----xxB-x------------xxx-xxx-------Exxx----------xxxx-------------xxXXXXXXXX--------XXX----------
x--xxxxx-b--xxxxxxxxxxxxx--xx--xxxxxxxxx--xxxxxxxxxxxEE-xxxxxxxxxxxxxxXXXXXXXXX--------XXX----------
X--XXXXXXXXXXXXXXXXXXXXXX--XX--XXXXXXXXX--XXXXXXXXXXXXXXXXXXXXXXXXXXXXXXXXXXXXXXX------XXX----------