-----------------------------------------------------------------------------------------xxxxxxx----
----------------------------------------xxxxxxxxxxxxxxxxxxxxxxxxxxxxxxxxxxxxxxxxxxxxxxxxxx-XXX--xxxx
SSSSSSSSSSSSSSSSSSSSSSSSSSSSSSS--------xxSSSSSSSSSSSSSSSSSSSSSSSSSSSSSSSSSSSSSSSSSSSSSSSSS------SSSS
SSSSSSSSSSSSSSSSSSSSSS----------------xx--------------------------------------------------------SSSS
SSSSSSSSSSSSSSSSSSSSSS-----------XXX-xx---------------------------------------------------------SSSS
SSSSSSSSSSSSSSSSSSSSSS--QQ------xxxx-xSSS-----------E-------------------------------------------SSSS
-------------------------------xx---xx-------------<>-------------------------------------------S---
xxx------------------xxx-xxx--xx-----xS------------[]-------------------------------------------S---
x?-xxxxxxxxxxxxxxxxxxx--xx--xxx------S-S-----------[]------S--------------E---E------------------?oo
???SSSSSSSSSSSSSSSSSSS--QQ--QQQ---------S-----E--SS[]----E----E----------<>--<>------------------??S
---SSSSSSSSSSSSSSSSSS------------------------<>----[]---<>---<>----------[]--[]----------XX---------
---SSSSSSSSSSSSSSSSSS------------------------[]----[]---[]---[]----------[]--[]---------XXXXXX------
oooSSSSSSSSSSSSSSSSSS------------------------[]-E--[]---[]---[]-------E--]]--[]--------XXXX---------
XXXXXXXXXXXXXXXXXXXXXXXXXXXXXXX------XXXXXXXXXXXXXXXXXXXXXXXXXXXXXXXXXXXXXXXXXXX-XXXXXXXXX-----XXXXX