----------------------------------------------------------------------------------------------------
----------------------------------------------------------------------------------------------------
----------------------------------------------------------------------------------------------------
----------------------------------------------------------------------------------------------------
--------------------------------------------------------------------------xxxxxx--------------------
---QQQQQ-----------SSSS--------SSSSS------SSSS---------------------------xx?SSS-x-------------------
-------------------------------------------------------------------------x-------x------------------
--------------------------------------------------------------------xxxxxx-------Ex--------------xxx
-----------------------xxxx-------------------------xxxx-----------xx---xE------<>-x----------xxxx-<
--E?QQQQ----------S---xx<>-x-QQQQ--QQQ-------------xx<>-x---------xx----<>---E--[]--x--------xxQQ?-[
x--------------------xx-[]--x---------------------xx-[]--x------xxx-----[]--<>--[]---x------xx-----[
-x------------------xx--[]---x-----------xxxxx---xx--[]---x----xx<>-----[]--[]--[]----x----xx------[
--xxxxxxxxxxxxxxxxxxx---[]----xxxxxxxxxxxx----xxxxE--[]----xxxxx-[]--E--[]--[]--[]-----xxxxx--X----[
XXXXXXXXXXXXXXXXXXXXXXXXXXXXXXXXXXXXXXXXXX----XXXXXXXXXX---XXXXXXXXXXXXXXXXXXXXXXXXXXXXXXXXXXXXXXXXX