----------------------------------------------------------------------------------------------------
----------------------------------------------------------------------------------------------------
----------------------------------------------------------------------------------------------------
----------------------------------------------------------------------------------------------------
--------------------------------ooo-----------------------------------------------------xxx---------
--------------------------------ooo-------------------------------------xxxx-----------xx--x--------
-----------------------------------------------------------------------xx---x---------xx----x------x
--------xxxxxx-----oooo---------xxxx-------xxx------------------xxxx--xx-----x-xxxxxxxx------x----xx
xxx---xxx--x--x----oooo--------xx---xxxxxxxx--x----------------xx---xxx-------xx-----x--------xxxxx-
xS-x-xxXX--X---x-------------Exx---XXXXXXEXX---x--------E-----xx----XXX-------XX----XX--------XXXXX-
----xxXXX--X----xxxxxxxxxxxxxxx----X-------X----xxxxxxxxxxxxxxx---------------------XXX-------------
S-SSxXXXX--X----XXXXXXXXXXXXXXX----X-------X---XXXXXXXXXXXXXXXX-----------XX------------------------
S-SSXXXXX--X----X-------------X----X-------X---X--------------X-------------------------------------
XXX-XXXXX--X----X-------------X----X-------X---X--------------X-------------------------------------