---xxx----------------------------------------------------------------------------------------------
--xx--x---------------------------------------------------------------------------------------------
-xx----x--------------------------------------------------------------------------------------------
xx------x-------------xxx---------------------------------------------------------------------------
x--------x---------xxxx--x---------------xxx--------------------------xxxx--------------------------
>---------x-------xx--X---x-------------xx--x-----E------------------xxXX-x-------------------------
]----------x-----xx--------x-----------xx-E--x-E--------------------xxXXX--x------------------------
]-----------xxxxxxE---------x---------xx------x--------------------xxXXXX---x--------------------xxx
]------------x---<>----------x----xxxxx--------x------------------xxXXXXX----x-----------------xxx--
]------------?---[]-----------x--xxXXXX---------x----------------xxXXXXXX-----x--------SSS----xx<>--
]----------------[]------------xxx---------------x--------------xxXXXXXXX------x-------------xx-[]--
]----------------[]-------------XXX---------------x------------xxXXXXXXXX-------xxx---------xx--[]--
]------E---------[]------------X-------------------xxxxxxxxxxxxxXXXXXXXXX-------XX-xxxxxxxxxx---[]--
XXXXXX<>XXXXXX---XXXXXXX-------XXXX----------------XXXXXXXXXXXXXXXXXXXXXXXXXXXXXXXXXXXXXXXXXXXXXXXXX