----------------------------------------------------------------------------------------------------
----------------------------------------------------------------------------------------------------
----------------------------------------------------------------------------------------------------
----------------------------------------------------------------------------------------------------
xxxxxx----------------------------------------------------------------------------------------------
xXXX--x--------------------------------------Q--------------------------------------Q-Q----------SSS
XXXX---x--------------------------------------------------------------------------------------------
XXXX----x-------------------------------------------------------------------------------------------
XXXX-----x----------------------------------------------------oo------------------------------------
XXXX------x-----------------------------xxxx-?---------------o--o-------------------Q-Q---------S---
XXXX-------x---------------------------xx<>-x------------------------------------------------------x
XXXX--------x-------------------------xx-[]--x-----xxx--------------------------------------------xx
XXXX---------xxxxxxxxxxxxxxxxxxxxxxxxxx--[]---xxxxxx--xxxxxxxxxxxxxxxxxxxxxxxxxxxxxxxxxxxxxxxxxxxxx-
XXXXXXXXXXXXXXXXXXXXXXXXXXXXXXXXXXXXXXXXXXXXXXXXXXXX--XXXXXXXXXXXXXXXXXXXXXXXXXXXXXXXXXXXXXXXXXXXXXX