----------------------------------------------------------------------------------------------------
----------------------------------------------------------------------------------------------------
----------------------------------------------------------------------------------------------------
----------------------------------------------------------------------------------------------------
-----------------------------------------------------------------xxxxx------------------------------
--------------------------Q-----------------------------------E-xxXXX-x-----------------------------
---------------------------------------------xxxx--------------xxXXXX--x----------------------------
--------------------------------------------xx---x------------xxXXXXX---x---------------------------
-------------------------------------------xx-----xxx-------xxxXXXXXX----x--------------------------
--------------------Q---S?SQS------------xxx------<>-x-----xx<>XXXXXX-----x------------------XXXX---
-------------------------------xxxx-----xx<>------[]--x---xx-[]XXXXXX------x------------------------
-----xxxxx--------------------xx<>-x---xx-[]------[]---x-xx-X[]XXXXXX-------xxx--------xxx---xxx---x
xxxxxx----xxxxxxxxxxxxxxxxxxxxx-[]--xxxx--[]-E----[]----xx-XX[]XXXXXX-------XX-xxxxxxxxx--xxxx--xxxx
XXXXXX----XXXXXXXXXXXXXXXXXXXXXXXXXXXXXXXXXXXXXXXXXXXXXXXXXXXXXXXXXXXXXXXXXXXXXXXXXXXXXX--XXXX--XXXX