----------------------------------------------------------------------------------------------------
----------------------------------------------------------------------------------------------------
----------------------------------------------------------------------------------------------------
----------------------------------------------------------------------------------------------------
----------------------------------------------------------------------------------------------------
-----------------------------x-------SSSSSSS----------XXXXXXXXXXXXXXXX-------------QQQQQ------------
------------------------------x---------------------------[]-------[]-------------------------------
-------------------------------xxxx--------xxx------------[]-------[]-------------------------------
----------------xxxx-?----------xB-xxxxxxxxx--x-----------[]-------[]-------xxx---------------------
o-xxx-----S----xx<>-x-----------XXXXESSSSSSS---x----------[]-------[]------xx<-x--E?QQQQ------------
-xxX-x--------xx-[]--x----------XXXXX-----------x---------<>-------<>-----xx-[]-x------------------x
xx-X--x------xx--[]---x--------XXXXXX------------x--------xxx------xxx---xx--[]--x----------------xx
x--X---xxxxxxx---[]----xxxxxxxXXXXXXX-----------B-xxxxxxxxxE-xxxxxxxE-xxxx---[]---xxxxxxxxxxxxxxxxx-
X--XXXXXXXXXXXXXXXXXXXXXXXXXXXXXXXXXXXXXXXXXXEXXXXXXXXXXXXXX-XXXXXXXX-XXXXX--XXXXXXXXXXXXXXXXXXXXXXX