----------------------------------------------------------------------------------------------------
----------------------------------------------------------------------------------------------------
---------------------------------------------?------------------------------------------------------
----------------------------------------------------------------------------------------------------
--------------------------------------------------------------xxxxx---------------------------------
----------------------------SSSSS-------------------xxxxx----xxXX--x--------------------------------
-----------------------------------------------SS--xx----x--xxXXX---x-------------------------------
--------------------------------------------------xxX-----xxxXXXX----x------------------------------
-----------------------------E-------------SS----xxXX------xXXXXX-----x-----------------------------
--------------------xxxx---SSSSSS-xxx-----------xxXXX------XXXXXX------x---------ooo----------------
xx-----------------xx<>-x--------xxX-x--B------xxXXXX-----XXXXXXX-------x---------------------------
E-x---------------xx-[]--x------xx-X--x-b----xxxXXXXX----XXXXXXXX--------xx--------xxx---xxx--------
--Exxxxxxxxxxxxxxxx--[]---xxxxxxx--X---xxxxxxx-XXXXXX---XXXXXXXXX--------X-xxxxxxxxx--xxxxE-xxxxxxxx
XXXXXXXXXXXXXXXXXXXXXXXXXXXXXXXXXXXXXXXXXXXXXX-XXXXXXXXXXXXXXXXXXXXXXXXXXXXXXXXXXXXX--XXXXXXXXXXXXXX