----------------------------------------------------------------------------------------------------
----------------------------------------------------------------------------------------------------
----------------------------------------------------------------------------------------------------
----------------------------------------------------------------------------------------------------
---------------------------------------------------------------------------------------xxxx---------
---S-------------------------------------------------------QQQQ-----------------------xxXX-x--------
----------------oooo----------oooo------------oooo-----------------------------------xxXXX--x-------
------------------------------------------------------------------------------------xxXXXX---x------
--------------------------xxxx------------xxxx-------------------------------------xxXXXXX----x-----
-QQQQ--------xxx---------xx<>-x----------xx<>-x----------QQ?SSQQQ-----------------xxXXXXXX-----x----
------------xxX-x-------xx-[]--x--------xx-[]--x------------------------xxxx-----xxXXXXXXX------x---
-----------xx-X--x-----xx--[]---x------xx--[]---x----------xxx---------xx<>-x---xxXXXXXXXX-------x--
xxxxxxxxxxxx--X---xxxxxx---[]----xxxxxxx---[]----xxxxxxxxxxx--xxxxxxxxxx-[]--xxxxXXXXXXXXX--------xx
XXXXXXXXXXXXXXXXXXXXXXXXXXXXXXXXXXXXXXXXXXXXXXXXXXXXXXXXXXXX--XXXXXXXXXXXXXXXXXXXXXXXXXXXXXXXXXXXXXX