----------------------------------------------------------------------------------------------------
----------------------------------------------------------------------------------------------------
----------------------------------------------------------------------------------------------------
---------------------------------------------------------------------------------xxx----------------
--------xxxxxxxxxxx-----------------------------------------------------------xxxx--x---------------
-------xx---x---XX-x------------SSSS----------xxxxx-----------------xx-------xx--X---x-----S--------
------xx-E--E---[]--x------------[]----------xx-<>-x---------------xx-x-----xx--------x----S--------
----xxx---------[]---x-----------[]---------xx--[]--x-------------xx---xxxxxxE---------x------------
---xx-E---------[]----x----------[]-------xxx---[]---x-----------xx-----x---<>----------x--SSS------
--xx------------[]-----xx--------[]------xx<>--QQQ?---x---------xx------?---[]-----------x-SSS------
-xx-------------<>-----B-x-------<>-----xx-[]----------x-------xxE----------[]------------xSSS------
xx---------------------b--x------xxx---xx--[]-----------x-----xx<>----------[]--------------SSx-----
xX---------------E-----B---xxxxxxxE-xxxx---[]------E-----xxxxxx-[]----------[]------------X-SS-xxxxx
XX-------------XXXXXXXXXXXXXXXXXXXXXXXXXEXXXX------X---XXXXXXXXXXXXXXXXXXX--XXXXXXX-------XXXXXXXXXX