----------------------------------------------------------------------------------------------------
----------------------------------------------------------------------------------------------------
----------------------------------------------------------------------------------------------------
----------------------------------------------------------------------------------------------------
----------------------------------------------------------------------------------------------------
-E--------------------------------------------SSSSSSS---------------E------E------------------------
SSSS-------------------------------------------------------------E----------------------------------
-------------------------------------------------------------xxxxxxxxxxxxxxx------------------------
-----------------------------------------------E--E---------xxXSSSSSSSSSSSS-x-------------xxxx------
SSSS---X--------------------------------------SSSSSSS------xxXX--------------x--------QQ-xx-X-x----x
----EE-X-----------------------------Q?QQQ----------------xxXXX----oooooo-----x---------xx--X--x--xx
SSSSSSSX---------------xxx-----------------------xxx-----xxXXXX----------------xxxx----xx---X---xxx-
xxxxxxxxxxxxxxxxxxxxxxxxE-xxxxxxxxxxxxxxxxxxxxxxxx--xxxxxxXXXXX----oooooo-------x--xxxxx----X----x--
XXXXXXXXXXXXXXXXXXXXXXXXXXXXXXXXXXXXXXXXXXXXXXXXXX--XXXXXXXXXXXXXXXXXXXXXXX-----X--XXXXX--XXXXXXXXXX