----------------------------------------------------------------------------------------------------
----------------------------------------------------------------------------------------------------
SSSSSSSSSSSSSS?SSSSSSSSSSSSSSSSSSSSSSSSSSSSSSSSSSSSSSSSSSSSSSSSS------------------------------------
-SSSS-----------------------------------------------------------------------------------------------
-SSSS-------------------------------------------------------------XXX-------------------------------
---------oooooo------------------------------------------------------------------XXX----------------
--------------------------------xx------------------------------------------------------------------
---------SSSSSS----------------xx-x-xxx-------------------------------------------------------------
--E------SSSSSS---------------xx---xx--x---------------------xxxxx-----SSSSS??--------------------xx
-SSSS-----------------------xxx----<>---x------xxxx---------xxXXX-xxxx---------------------------xxX
EE-------------------------xx<>----[]----xxx--xxSS-x-------xxEXXX-XXX-x-------------------------xx--
----xxxxx-----------------xx-[]----[]----<>-xxx-SS--x-----xxXXXXX------x------xxx---------xxxxxxx---
xxxxx----xxxxxxxxxxxxxxxxxx--[]----[]--E-[]--x--SS---xxxxxxXXXXXX-------xxxxxxx--xxxxxxxxxx--XXXX---
XXXXX---XXXXXXXXXXXXXXXXXXXXXXXXXXXXXXXXXXXXXX--XX--XXXXXXXXXXXX-------XXXXXXXX--XXXXXXXXXX---------