----------------------------------------------------------------------------------------------------
----------------------------------------------------------------------------------------------------
SSSSSSSSSSSSSSSSSSSSSSSSSSSSSSSSSSSSSSSSSSSSSSSSSSSSSSSSSSSSSSSSSSSSSSSSSS?SSSSSSSSSSSSSSSSSSSSSSSSS
--------------------------------------SS--SSSSSS--SSSS------SSSS-------------------------------SSSSS
--------------------------------------SS--SSSSSS--SSSS--E---SSSS-------------------------------SSSSS
------------------------oooo--------SS--------SS---S----SS----------ooooooo--------------------SSSSS
-------------o----------------------SS--------SS---S----SS------------------------------------------
---------xxxxx--------S-SSSS-S------SS--------SS---S----SS----------SSSSSSS-------------------------
-----xxxxx--S-x-------SoS--SoS------SS----ooooSS---So??-SS---E------SSSSSSS--------------------xxxxx
---xxxXXXX-----xx-----SSS--SSS------SSSS--SSSSSS---SSS--SS--SSSS------------------------------xx-SSS
-xxxXXXXXXXX--XX-xx-------------------SS-------------------EE--------------------------------xx--SSS
xxXXXXXXXXXX--XXXX-x------------------SS-----------------------xxxxx-----------------xxx-xxxxx---SSS
XXXXXXXXXXXXE-XXXX--xxxxxxxxxxxxxxxxxxxxxxxxxxxxxxxxxxxxxxxxxxxx----xxxxxxxxxxxxxxxxxx--xx--x-------
XXXXXXXXXXXXXXXXXXXXXXXXXXXXXXXXXXXXXXXXXXXXXXXXXXXXXXXXXXXXXXXX---XXXXXXXXXXXXXXXXXXX--XX--X---XXXX