----------------------------------------------------------------------------------------------------
---------------------------------------------x------------------------------------------------------
----------------------------------------------x---SSSSSSSSSSSSSSSSSSSSSSSSSSSSSSSSSSSSSSSSSSSSSSSSSS
----------------------------------------------------[]----[]-------[]-------------------------------
---------------------------xxxxxxxxxxx--------------[]----[]-------[]-------E-----------------------
--------------------------xx---x---XX-x-------------[]----[]-------[]---QQQQQQ--------xxxx----------
-------------------------xx-E--E---[]--x------------<>----[]-------[]----------------xxSSS----------
-----------------------xxx---------[]---x-----------------[]-------[]---------------xx-SSS----------
----xxxx--------------xx-E---------[]----x----------------[]-------[]--xxxxxxxxxxxxxx--SSS--------xx
---xxX--x------------xx------------[]-----xx--------------[]-------[]-xxSSSSSSSSSSSSS--SSS--------x<
--xx-X---x----------xx-------------<>-----B-x-------------<>-------<>xx-SSSSSSSSSSSSS------------xx[
-xx--X----x--------xx---------------------b--x-----xxx-----xx-------xx--SSSSSSSSSSSSS-----x-----xx-[
xx--EX-----xxxxxxxxxX---------------E-----B---xxxxxx--xxxxxE-xxxxxxxx---SSSSSSSSSSSSS------xxxxxx--[
XXEXXX-----XXEXXXXXXX-------------XXXXXXXXXXXXXXXXXX--XXXXXXXXXXEXXXXE--XXXXXXXXXXXXXXXXXXXXXXXXXXXX