----------------------------------------------------------------------------------------------------
----------------------------------------------------------------------------------------------------
----------------------------------------------------------------------------------------------------
----------------------------------------------------------------------------------------------------
----------------------------------------------------------------------------------------------------
--------------------------------------------------------------------------------------xxxxS-------SS
-------------------------------------------------------------------------------------xx--xxx--------
------------------------------------------------------------------------------------xx------x-xxx---
---------------------------Q--?----------------E-----------------------------------xx----E-EExx--xx-
-X----------------------Q-E------ESSS----E----<>------------------E--S------------xxX--------XX-XX-x
-X------------------------E-------------<>-----------------------<>---------E----xxXXX-------XX-XX--
QX-----------xxx------------------------------------xxxxx------------------<>---xxXXXX-------XX-XXX-
xxxxxxxxxxxxxx--xxxxxxxxxxxxxxxxxxxxxxxxxxxxxxxxxxxxx----xxxxxxxxxxxxxxxxxxxxxxxxXXXX--------X--XXX-
XXXXXXXXXXXXXX--XXXXXXXXXXXXXXXXXXXXXXXXXXXXXXXXXXXXX---XXXXXXXXXXXXXXXXXXXXXXXXXXXXX--------X--XXXX