----------------------------------------------------------------------------------------------------
xxxxxxxxxxxxxxxxxxxxx-------------------------------------------------------------------------------
SSSSSSSSSSSSSSSSSSSSS------------------------------------------------------XXXX---------------------
-----------------[]---------------------------------------------------------[]----------------------
-----------------[]---------------------------------------------------------[]----------------------
-----------------[]---------------------------------------------------------[]----------------------
-----------------[]----------X--EX------------------------------------------[]----------------------
-----------------<>----------X---X------------------------------------------[]----------------------
-----------------------X---X-X---X---------X-EE----X--------------ooo-------[]-----xxx--------------
----------<>-----------XSSSX-XSS?X----Q----XSSSSSSSX--------------ooo-------<>----xxX-x-------------
----------[]----S-S-S------------------------------------------------------------xx-X--x------------
ooooooo---[]----S-S-S------------------xxx--------------------------------------xx--X---x-----------
ooooooo---[]----S-S-Sxxxxxxxxxxxxxxxxxxx--xxxxxxxxxxxxxxxxxxxxxxxxxxxxxxxxxxxxxxx--EX----xxxxxxxxxxx
XXXXXXX---[]----S-S-SXXXXXXXXXXXXXXXXXXX--XXXXXXXXXXXXEEXEXXXXXXXXXXXXXEXEXXXXXXXXXXX----XXXXXXXXXXX