----------------------------------------------------------------------------------------------------
----------------------------------------------------------------------------------------------------
-------------------------------------------------------------------------------?--------------------
----------------------------------------------------------------------------------------------------
---------------E------------------------------------------------------------------------------------
-----------SSSSSS----S----------------------------------------SSSSS-------------------xxxxx---------
---------------------------------------------------------------------------------SS--xx----x-------x
------------------------------------------------------------------------------------xxX-----x-----xx
------------E-------------------------xxxxx--------------------E-------------SS----xxXX------xxxxxx-
--xxxxx---SSSSSSS---xxxx------------xxx----x------------------SSSSS-xxx-----------xxXXX-------xXXX--
-xx-<>-x-----------xx<>-x----------xx<>-----xx---------xxxx--------xxX-x--B------xxXXXX------XXXXX--
xx--[]--x---------xx-[]--x------B-xx-[]----<>-x---B---xx<>-x------xx-X--x-b----xxxXXXXX-----XXXXXX--
x---[]---xxxxxxxxxx--[]---xxxxxxxxx--[]-E--[]--xxxxxxxx-[]--xxxxxxx--X---xxxxxxx-XXXXXX----XXXXXXX--
X--XXXXXXXXXXXXXXXXXXXXXXXXXXXXXXXXXXXXXXXXXXXXXXXXXXXXXXXXXXXXXXXXXXXXXXXXXXXXX-XXXXXXXXXXXXXXXXXXX