----------------------------------------------------------------------------------------------------
----------------------------------------------------------------------------------------------------
-------------------------------------------------------------------------------------SSSSSSSSSSSSSSS
----------------------------------------------------------------------------------------------------
--------------------------------------------------------------------xxxxx---------------------------
--------SSQSSS?SSS--------SSS--------------------------------------xxXX--x--------------------------
-------------------------------------xxxx-------------------------xxXXX---x-------------------------
------------------------------------xxXX-x-----------------------xxXXXX----x------------------------
-E------------------------SSS------xxXXX--x---------------------xxXXXXX-----x-----------------------
<>------SSSSSSSSSSS---------------xxXXXX---x-----SSQS--------xxxxXXXXXX------x----------QQQQQ-----xx
---------------------------------xxXXXXX----x-x------------xxx--XXXXXXX-------x-----------------xxxX
------------------------xxxxx---xxXXXXXX-----x>x----------xx<>-XXXXXXXX--------xx-------------xxxXXX
xxxxxxxxxxxxxxxxxxxxxxxxx----xxxxXXXXXXX-----<]-xxxxxxxxxxx-[]XXXXXXXXX--------X-xxxxxxxxxxxxxxXXXXX
XXXXXXXXXXXXXXXXXXXXXXXXX----XXXXXXXXXX--XXXXXXXXXXXXXXXXXXXXXXXXXXXXXXXXXXXXXXXXXXXXXXXXXXXXXXXXXXX