----------------------------------------------------------------------------------------------------
----------------------------------------------------------------------------------------------------
--------SSSSSSSSSSSSSSSSSSSSSSSSSSSSSSSSSSSSSSSSSSSSSSSSSSSSSSSSSSSSSSSSSSSSSSSSSSSSSSSSSSSSSSSSSSSS
----------------------SSSSSSSSSSSSSSSSSSSSSSSSSS----------------------SSSSSSSSSSSSSSSSSSSSSSSSS-----
----------------------SSSSSSSSSSSSSSSSSSSSSSSSSS----------------------SSSSSSSSSSSSSSSSSSSSSSSSS-----
----------------------SSSSSSSSSSSSSSSSSSSSSSSSSS--QQ------------------SSSSSSSSSSSSSSSSSSSSSSSSS-----
--------------------------------------------------------------------------------------------------xx
-----------------------------xxx---------------xxx-xxx----------------------------xxxxx------xxxxxx-
----------------------xxxxxxxx?-xxxxxxxxxxxxxxxx--xx--xxxxxxxxxxxxxxx-xxxxxxxxxxxxx----xxxxxxxE--<>-
x--------------------xx-SSSSSS??SSSSSSSSSSSSSSSS--QQ--QQS?SSSSSS??????SSSSSSSSSSSS?----SSSSSSSS--[]-
-x------------------xx--SSSSS---SSSSSSSSSSSSSSSS---------SSSSSSSSSSSSS---------------------------[]-
--xx--------xxx-xxxxx---SSSSS---SSSSSSSSSSSSSSSS---------SSSSSSSSSSSSS--------------<>-----------[]-
--X-xxxxxxxxx--xx--x---------oooSSSSSSSSSSSSSSSS------------------------------------[]-----------[]-
XXXXXXXXXXXXX--XX--X---XXXXXXXXXXXXXXXXXXXXXXXXXXXXXXXXXXXXX-XX-XXXXXXXXXXXXXXXXXXXXXXXXXXXXXXXXXXXX