----------------------------------------------------------------------xxxxxx------------------------
xxxxxxxxxxxxxxxxxxxxxxxxxxxxx--------------xxxxxxxxxxxxxxxxxxxxxxxxxxxx-XXX-xxxxxxxxxxxxxxxxxxxxxxxx
SSSSSSSSSSSSSSSSSSSSSSSSSSSS-x-----SSSS---xxSSSSSSSSSSSSSSSSSSSSSSSSSSS-----SSSSSSSSSSSSSSSSSSSSSSSS
------------------------------x----------xx---------------------------------SSSS--------------------
-------------------------------x----?---xx----------------------------------SSSS--------------------
--------------------------------x--S??-xx-----------------------------------SSSS----E---------------
---------------------------------x----xxXXX---------------------------------S------<>---------------
----------------------------------x--xx-------------------------------------S------[]------------E--
------------------------E----------xxx---------------------E------------------E----[]-----------<>--
EQQQQQ-E---------------<>------XXX-SSSS----------------E--<>-----------------<>---?SSS--E-------[]--
>-----<>------------XX-[]--XXX------------------E-----<>--[]----------XX-----[]--------<>-------[]--
]-----[]-----------XXX-[]--XXX-----------------<>-----[]--[]---------XXXXXX--[]--------[]---<>--[]--
]-E---[]-------E-E-XXX-[]--XXX-----------------[]---E-[]--[]--------XXXX-----[]--------[]---[]--[]--
XXXXXXXXXXXXXXXXXXXXX--XX--XX------XXXX------XXXXXXXXXXXXXXX--XXXXXXXXX-----XXXXXX----XXX---XX--XX--