----------------------------------------------------------------------------------------------------
----------------------------------------------------------------------------------------------------
SSSSSSSSSSSSSSSSSSSSSSSSSSSSSSSSSSSSSSSSSSSSSSSSSSSSSSS?SSSSSSSSSSSSSSSSSSSSSSSSSSSSSSSSSSSSSSSSSSSS
--------------------SS--SSSSSS--SSSS------SSSS------------------------------------------------------
--------------------SS--SSSSSS--SSSS--E---SSSS------------------------------------------------------
-------oooo-------SS--------SS---S----SS----------oooooo--------------------------------------------
------------------SS--------SS--------SS--------------------------------xx--------------------------
-----S-SSSS-S-----SS--------SS---S----SS----------SSSSSS---------------xx-x-xxx---------------------
X----SoS--SoS-----SS----ooooSS---So??-SS---E------SSSSSS--------------xx---xx--x--------------------
X----SSS--SSS-----SSSS--SSSSSS---SSS--SS--SSSS----------------------xxx----<>---x------xxxx---------
X-------------------SS-------------------EE------------------------xx<>----[]----xxx--xxSS-x-------x
--------------------SS-----------------------xxxxx----------------xx-[]----[]----<>-xxx-SS--x-----xx
xxxxxxxxxxxxxxxxxxxxxxxxxxxxxxxxxxxxxxxxxxxxxx----xxxxxxxxxxxxxxxxx--[]----[]--E-[]--x--SS---xxxxxx-
XXXXXXXXXXXXXXXXXXXXXXXXXXXXXXXXXXXXXXXXXXXXXX---XXXXXXXXXXXXXXXXXXXXXXXXXXXXXXXXXXXXX--XX--XXXXXXX-