----------------------------------------------------------------------------------------------------
xxxxxxxxxxxxxxxxxxx--------------xxxxxxxxxxxxxxxxxxxxxxxxxxxxxxxxxxxxxxx--------------xxxxxxxxxxxxxx
SSSSSSSSSSSSSSSSSS-x-----SSSS---xxSSSSSSSSSSSSSSSSSSSSSSSSSSSSSSSSSSSSS-x-----SSSS---xxSSSSSSSSSSSSS
--------------------x----------xx----------------------------------------x----------xx--------------
---------------------x----?---xx------------------------------------------x----?---xx---------------
----------------------x--S??-xx--------------------------------------------x--S??-xx----------------
-----------------------x----xxXXX-------------------------------------------x----xxXXX--------------
------------------------x--xx------------------------------------------------x--xx------------------
--------------E----------xxx---------------------E-----------------E----------xxx-------------------
-------------<>------XXX-SSSS----------------E--<>----------------<>------XXX-SSSS----------------E-
----------XX-[]--XXX------------------E-----<>--[]-------------XX-[]--XXX------------------E-----<>-
>--------XXX-[]--XXX-----------------<>-----[]--[]------------XXX-[]--XXX-----------------<>-----[]-
]----E-E-XXX-[]--XXX-----------------[]---E-[]--[]--------E-E-XXX-[]--XXX-----------------[]---E-[]-
X--XXXXXXXX--XX--XX------XXXX------XXXXXXXXXXXXXXX--XXXXXXXXXXXX--XX--XX------XXXX------XXXXXXXXXXXX