----------------------------------------------------------o-----------------------------------------
------------------------------xxxxxxxxxxxxxxxxxxxxxxxxxxxxxxxxxxxx----------------------------------
------------------------------xXXXXXXXXXXXXXXXXXXXXXXXXXXXXQSSSSS-x-------------SSSSSSSSSSSSSSSSSSSS
-----------------------------xxXXXXXXXXXXXXXXXXXXXXXXXXXXXX--------xx-------------[]----------------
----------------------xx----xx-XXXXXXXXXXXXXXXXXXXXXXXXXXXX------XXX-x------------[]----------------
----------------------------xS-XXXXXXXXXXXXXXXXXXXXXXXXXXXX-----------x-----------[]-----oooo-------
----------------------------x--XXXXXXXXXXXXXXXXXXXXXXXXXXXX------------x----------<>----------------
---------------------------xx--XXXXXXXXXXXXXXXXXXXXXXXXXXXX-------------x--------------S-SSSS-S-----
--------------------------xxS--XXXXXXXXXXXXXXXXXXXXXXXXXXXX--------------x-------------SoS--SoS-----
--------------------------x----XXXXXXXXXXXXXXXXXXXXXXXXXXXX---------------x------S-----SSS--SSS-----
---------xxx-------------xx----XXXXXXXXXXXXXXXXXXXXXXXXXXXX----------------x------------------------
--xxx---xxB-x-----------xx---E-XXXXXXXXXXXXXXXXXXXXXXXXXXXX-----------------x----xxx----------------
xxx--xxxx-b--xxxxxxxxxxxx------XXXXXXXXXXXXXXXXXXXXXXXXXXXX----------------X-xxxxx--xxxxxxxxxxxxxxxx
XXX--XXXXXXXXXXXXXXXXXXXXXXXXXXXXXXXXXXXXXXXXXXXXXXXXXXXXXXo-------------XXXXXXXXX--XXXXXXXXXXXXXXXX