----------------------------------------------------------------------------------------------------
----------------------------------------------------------------------------------------------------
----------------------------------------------------------------------------------------------------
-------------------------------------xxx------------------------------------------------------------
---------------------------xxxx----xxx--x-----------------------------------------------------------
E-E-E------------S--------xx---x--xxXS---x----------------------------------------------------------
><><>--------------------xx-----xxxEX-----x---------------------------------------------------------
][][]-------------------xx-------xXXX------x--------------------------------------------------------
QQQQQ--------------xxxxxx--------XXXXS------x------------------B-----------------------------E------
--------------Q--xxx---<>-------XXXXX--------x---------B-------b----------------------------<>------
---------xxxx---xx<>---[]------XXXXXX---------x--------b--?-B------?QQ----------------------[]------
--E-----xx<>-x-xx-[]---[]-----XXXXXXX----------x-------B----b----------------------xxx------[]---xxx
xxxxxxxxx-[]--xx--[]---[]----XXXXXXXX---------X-xxxxxxxxxxxxxxxxxxxxxxxxxxxxxxxxxxxx--xxxxxxxxxxxx--
XXXXXXXXXXXXX-XXX-XX--XXXXX-XXXXXXXXXXXXXXXXX-XXXXXXXXXXXXXXXXXXXXXXXXXXXXXXXXXXXXXX--XXXXXXXXXXXX--