----------------------------------------------------------------------------------------------------
----------------------------------------------------------------------------------------------------
----------------------------------------------------------------------------------------------------
----------------------------------------------------------------------------------------------------
-------------------------------------------------------------------------------xxxxxx---------------
---------QQQQ------------SSSS--------SSSSS------SSS---------------------------xx?SSS-x--------------
------------------------------------------------------------------------------x-------x-------------
-------------------------------------------------------------------------xxxxxx-------Ex------------
-xxxx------------------------xxxx------------------------xxxx-----------xx---xE------<>-x-----------
xx<>-x--E?QQQ-----------S---xx<>-x-QQQQ--QQQ------------xx<>-x---------xx----<>---E--[]--x----------
x-[]--x--------------------xx-[]--x--------------------xx-[]--x------xxx-----[]--<>--[]---x---------
S-[]---x------------------xx--[]---x-----------xxxx---xx--[]---x----xx<>-----[]--[]--[]----x-xxxxx--
--[]----xxxxxxxxxxxxxxxxxxx---[]----xxxxxxxxxxxx---xxxxE--[]----xxxxx-[]--E--[]--[]--[]-----xx----xx
XXXXXXXXXXXXXXXXXXXXXXXXXXXXXXXXXXXXXXXXXXXXXXXX---XXXXXXXXXX---XXXXXXXXXXXXXXXXXXXXXXXXXXXXXX---XXX