----------------------------------------------------------------------------------------------------
xxxxxxxxxxxxxxxxxxx---------------------------------------------------------------------------------
SSSSSSSSSSSSSSSSSSS---------------------------------------------------------------------------------
---------------[]-----------------------------------------------------------------------------------
---------------[]-----------------------------------------------------------------------------------
---------------[]---------------------------------------------------------------------------------QQ
---------------[]----------X--EX--------------------------------------------------------------------
---------------<>----------X---X--------------------------------------------------------------------
---------------------X---X-X---X--------X-EE----X-------------ooo-------------ooo-------------------
--------<>-----------XSSSX-XSS?X--------XSSSSSSSX-------------ooo-------------o--o----------------Q-
--------[]----S-S-S---------------------------------------------------------------------------------
ooooo---[]----S-S-S-----------------xxx------------------------------------------------------------E
ooooo---[]----S-S-Sxxxxxxxxxxxxxxxxxx--xxxxxxxxxxxxxxxxxxxxxxxxxxxxxxxxxxxXxxxxxxxxxxxxxxxxxxxxxxxxx
XXXXX---[]----S-S-SXXXXXXXXXXXXXXXXXX--XXXXXXXXXXXXEEXEXXXXXXXXXXXXEEXEXXXXXXXXXXXXXXXXXXXXXXXXXXXXX