----------------------------------------------------------------------------------------------------
---------------------------------------------------------xxx----------------------------------------
-------------------SS-------------------XXXX------------xx--x---------------------------------------
-------------------[]--------------------[]------------xx----xx-------------------------------------
-------------------[]--------------------[]-----------xx-----E-xxxxxx-------------------------------
-------------------<>--------------------[]---------xxx---------x----x-------SSSSSS----------XXXXXXX
oo---------------------------------------[]--------xx-S--------<>-----x--------------------------[]-
--------------------E--------------------[]-------xx-----------[]------xxxx-------xxx------------[]-
-----------------xxxx--------------------[]------xx------------[]-------xB-xxxxxxxx--x-----------[]-
----------------xx<>-x-QQQQQQ?QQQQQQQ?Q--<>-----xx-------X-----XX-------XXXXESSSSSS---x----------[]-
---------------xx-[]--x------------------------xxE---------------------XXXXXX----------x---------<>-
--------------xx--[]---x----------------------xx<>--------------------XXXXXXX-----------x--------xxx
xxxxxxxxxxxxxxx---[]----xxxxxxxxxxxxxxxxxxxxxxx-[]-----X-------------XXXXXXXX----------B-xxxxxxxxxE-
XXXXXXXXXXXXXXXXXXXXXXXXXXXXXEEXXXXXEXEXXXXXXXXXXXXXXXXX-------------XXXXXXXXXXXXXXXEXXXXXXXXXXXXXX-