----------------------------------------------------------------------------------------------------
---------------------------------------------------------------------------------xxx---x------------
--------------------------------------------------------------------------------xx--x---xx----------
-------------------------------------------------------------------------------xx----xx<>-x---------
-xxxxxxxxxxx---------xE-E------------------xxxxx------------------------xxx---xx-----E-[]--x------xx
xx--QQQ?QQQ-x-------SSSSSSS-SS-xxxx-----xxxx--X-x----------------------xx--x-xx--------[]---x----xxX
x------------x-------------E--xx---x---xx--E--X--x--------------------xx-E--xx---------XX----x--xxXX
------E-------x--------------xx-----x-xx---XX-X---x------------------xx-----XX----------------xxxXXX
----SSSSSSS----x-----------xxx-------xx----XX-X----x-----------xxxxxxx-------------------------xXXXX
-------------E--x---------xx<>-------<>----XX-X-----x---------xx-XXXXX-------o-----------------XXXXX
------X------X---x---E---xx-[]-------[]----XX-X------x-------xx--------------o--XX-------------XXXXX
------X------X----x-----xx--[]-------[]----XX-X-------S-----xx---------------------------------XXXXX
---E--X------X-----xxxxxx---[]-------[]----XX-X-------xxxxxxx----------------------------------XXXXX
XXXXXXXXXXXXXXXXXXXXXXXXXXXXXX-------XX-XXXXX-XXXXXXXXXXXXXXX----------------------------------XXXXX