------------------------------------------------------------xxx--------xxx---------xxxx-------------
-----------------------------------------------------------xx--x------xx--x-------xx---x------------
----------------------------------------------------------xx----x----xx----x-----xx-----x-----------
---------------------------------------------------------xx------x--xx------x---xx-------x-xxx------
-------------------------------------------------------xxx--------xxx--------xxxx---------xx--x-----
------------------------------------------------------xxXX--------XXX--------XXXX---------XX---x----
-----------------------------------------------------xxXXX--------XXX--------XXXX---------XX----x---
----------------------------------------------------xxXXXX--------XXX--------XXXX---------XX-----x--
x--------------------------------------------------xxXXXXX--------XXX--------XXXX---------XX------x-
xxx-----------------------------------------------xxXXXXXXS-------XXX--------XXXX---------XX-------x
xB-x----------------E----------------------------xxXXXXXXXS-------XXX--------XXXX---------XX--------
xb--x-------------------------xxxxxx------------xxXXXXXXXX--------XXX--------XXXX---------XX--------
-BEE-xxxxxxxxxxxxxxxxxxxxxxxxxxE-EE-xxxxxxxxxxxxxXXXXXXXXX--------XXX--------XXXX---------XX--------
XXXXXXXXXXXXXXXXXXXXXXXXXXXXXXXXXXXXXXXXXXXXXXXXXXXXXXXXXXXX------XXX--------XXXX---------XXXXXXXXX-